+--+--+--+--+--+--+--+--+--+--+--+--+--+--+--+--+--+--+--+--+--+--+--+--+--+--+--+--+--+--+
|           |        |              |     |                 |           |        |     |  |
|           |        |              |     |                 |           |        |     |  |
+  +  +--+  +  +--+  +  +  +--+--+  +  +  +--+--+  +--+--+  +  +--+--+  +  +  +--+  +  +  +
|  |     |     |        |     |  |     |        |     |     |     |        |        |     |
|  |     |     |        |     |  |     |        |     |     |     |        |        |     |
+  +--+  +  +  +--+--+--+--+  +  +--+--+--+  +--+--+  +  +--+--+  +  +--+  +--+--+--+  +--+
|  |     |  |     |     |     |        |              |           |     |           |     |
|  |     |  |     |     |     |        |              |           |     |           |     |
+  +  +--+  +--+  +  +  +  +--+--+  +--+  +--+  +  +--+  +  +--+--+--+  +--+--+  +--+--+  +
|  |  |  |     |     |           |        |     |     |  |           |  |        |     |  |
|  |  |  |     |     |           |        |     |     |  |           |  |        |     |  |
+  +  +  +--+  +--+--+--+  +--+  +--+  +--+  +--+--+  +  +--+--+--+  +  +  +  +--+  +  +  +
|     |        |           |  |  |     |     |     |     |     |           |  |     |     |
|     |        |           |  |  |     |     |     |     |     |           |  |     |     |
+  +  +  +--+--+  +--+--+--+  +  +  +  +  +--+  +  +  +--+  +  +  +  +--+--+  +  +--+--+  +
|  |                    |     |     |  |     |  |  |  |  |  |  |  |  |     |     |        |
|  |                    |     |     |  |     |  |  |  |  |  |  |  |  |     |     |        |
+  +  +--+--+--+--+  +--+  +  +--+--+  +  +  +--+  +  +  +  +--+  +  +  +  +--+--+  +--+  +
|     |                 |  |              |           |           |     |           |     |
|     |                 |  |              |           |           |     |           |     |
+  +--+  +--+--+--+--+  +  +--+--+  +--+--+  +--+--+  +  +--+--+--+--+--+  +--+--+--+  +--+
|  |     |     |     |     |        |     |     |     |                 |  |  |        |  |
|  |     |     |     |     |        |     |     |     |                 |  |  |        |  |
+--+  +--+  +  +  +  +  +--+  +--+--+  +--+--+  +  +--+--+--+  +  +--+--+  +  +  +--+--+  +
|     |     |     |  |                       |  |  |     |     |           |           |  |
|     |     |     |  |                       |  |  |     |     |           |           |  |
+  +--+  +--+--+--+  +--+--+  +--+--+--+--+  +  +  +  +  +  +--+  +  +--+--+  +--+--+  +  +
|                                                     |     |     |                       |
|                                                     |     |     |                       |
+--+--+--+--+--+--+--+--+--+--+--+--+--+--+--+--+--+--+--+--+--+--+--+--+--+--+--+--+--+--+
